006|008
_#####
_#  .#
##   #
#..$.#
# #$ #
#  $$#
###@ #
__####
