006|008
######
#+ $ #
# $  #
# #  #
#  $##
#.# #_
#.  #_
#####_
