008|009
__#####_
###   #_
#. @$ #_
### $.#_
#.##$ #_
# # . ##
#$ *$$.#
#   .  #
########
