006|008
__####
__# .#
### @#
#. $.#
# #  #
# $$ #
###  #
__####
